40:2 41:2 42:2 43:2 42:2 43:2 42:1 43:1 44:1 45:1 11:1 12:1 13:1 14:1 15:1 16:1 17:1 18:1 19:1 2102:1 21:1 22:1 23:1 24:1 25:1 102:1 102:1 102:1 102:1 102:1 102:1 102:1 102:1 102:1 102:1 102:1 102:1 102:1 102:1 1:1 
60:2 61:1 62:1 63:1 62:1 63:1 62:1 63:1 64:1 65:1 102:1 102:1 102:1 102:1 102:1 102:1 102:1 102:1 102:1 102:1 102:1 102:1 102:1 102:1 102:1 102:1 102:1 102:1 102:1 102:1 102:1 102:1 102:1 102:1 102:1 102:1 102:1 102:1 102:1 1:1 
80:2 81:1 82:1 83:1 82:1 83:1 82:1 83:1 84:1 85:1 102:1 102:1 102:1 102:1 102:1 102:1 102:1 102:1 102:1 102:1 102:1 102:1 102:1 102:1 102:1 102:1 102:1 102:1 102:1 102:1 102:1 102:1 102:1 102:1 102:1 102:1 102:1 102:1 102:1 1:1 
100:2 101:1 102:1 103:1 102:1 103:1 102:1 103:1 104:1 105:1 102:1 102:1 102:1 102:1 102:1 102:1 102:1 102:1 102:1 102:1 102:1 102:1 102:1 102:1 102:1 102:1 102:1 102:1 102:1 102:1 102:1 102:1 102:1 102:1 102:1 102:1 102:1 102:1 102:1 1:1 
80:2 81:1 82:1 83:1 82:1 83:1 82:1 83:1 84:1 85:1 102:1 102:1 102:1 102:1 102:1 102:1 102:1 102:1 102:1 102:1 102:1 102:1 102:1 102:1 102:1 102:1 102:1 102:1 102:1 102:1 102:1 102:1 102:1 102:1 102:1 102:1 102:1 102:1 102:1 1:1 
100:2 101:1 102:1 103:1 102:1 103:1 102:1 103:1 104:1 105:1 102:1 102:1 102:1 102:1 102:1 102:1 102:1 102:1 102:1 102:1 102:1 102:1 102:1 102:1 102:1 102:1 102:1 102:1 102:1 102:1 102:1 102:1 102:1 102:1 102:1 102:1 102:1 102:1 102:1 1:1 
80:2 81:2 82:2 83:2 82:2 83:2 82:1 83:1 84:1 85:1 102:1 102:1 102:1 102:1 102:1 102:1 102:1 102:1 102:1 102:1 102:1 102:1 102:1 102:1 102:1 102:1 102:1 102:1 102:1 102:1 102:1 102:1 102:1 102:1 102:1 102:1 102:1 102:1 102:1 1:1 
10102:1 101:1 102:1 103:1 102:1 103:1 102:1 103:1 104:1 105:1 102:1 102:1 102:1 102:1 102:1 102:1 102:1 102:1 102:1 102:1 102:1 102:1 102:1 102:1 102:1 102:1 102:1 102:1 102:1 102:1 102:1 102:1 102:1 102:1 102:1 102:1 102:1 102:1 102:1 1:1 
12102:1 121:1 122:1 123:1 122:1 123:1 122:1 123:1 124:1 125:1 102:1 102:1 102:1 102:1 102:1 102:1 102:1 102:1 102:1 102:1 102:1 102:1 102:1 102:1 102:1 102:1 102:1 102:1 102:1 102:1 102:1 102:1 102:1 102:1 102:1 102:1 102:1 102:1 102:1 1:1 
14102:1 141:1 142:1 143:1 142:1 143:1 142:1 143:1 144:1 145:1 102:1 102:1 102:1 102:1 102:1 102:1 102:1 102:1 102:1 102:1 102:1 102:1 102:1 102:1 102:1 102:1 102:1 102:1 102:1 102:1 102:1 102:1 102:1 102:1 102:1 102:1 102:1 102:1 102:1 1:1 
16102:1 161:1 162:1 163:1 162:1 163:1 162:1 163:1 164:1 165:1 102:1 102:1 102:1 102:1 102:1 102:1 102:1 102:1 102:1 102:1 102:1 102:1 102:1 102:1 102:1 102:1 102:1 102:1 102:1 102:1 102:1 102:1 102:1 102:1 102:1 102:1 102:1 102:1 102:1 1:1 
102:1 102:1 102:1 102:1 102:1 102:1 102:1 102:1 102:1 102:1 102:1 102:1 102:1 102:1 102:1 102:1 102:1 102:1 102:1 102:1 102:1 102:1 102:1 102:1 102:1 102:1 102:1 102:1 102:1 102:1 102:1 102:1 102:1 102:1 102:1 102:1 102:1 102:1 102:1 1:1 
102:1 102:1 102:1 102:1 102:1 102:1 102:1 102:1 102:1 102:1 102:1 102:1 102:1 102:1 102:1 102:1 102:1 102:1 102:1 102:1 102:1 102:1 102:1 102:1 102:1 102:1 102:1 102:1 102:1 102:1 102:1 102:1 102:1 102:1 102:1 102:1 102:1 102:1 102:1 1:1 
102:1 102:1 102:1 102:1 102:1 102:1 102:1 102:1 102:1 102:1 102:1 102:1 102:1 102:1 102:1 102:1 102:1 102:1 102:1 102:1 102:1 102:1 102:1 102:1 102:1 102:1 102:1 102:1 102:1 102:1 102:1 102:1 102:1 102:1 102:1 102:1 102:1 102:1 102:1 1:1 
102:1 102:1 102:1 102:1 102:1 102:1 102:1 102:1 102:1 102:1 102:1 102:1 102:1 102:1 102:1 102:1 102:1 102:1 102:1 102:1 102:1 102:1 102:1 102:1 102:1 102:1 102:1 102:1 102:1 102:1 102:1 102:1 102:1 102:1 102:1 102:1 102:1 102:1 102:1 1:1 
102:1 102:1 102:1 102:1 102:1 102:1 102:1 102:1 102:1 102:1 102:1 102:1 102:1 102:1 102:1 102:1 102:1 102:1 102:1 102:1 102:1 102:1 102:1 102:1 102:1 102:1 102:1 102:1 102:1 102:1 102:1 102:1 102:1 102:1 102:1 102:1 102:1 102:1 102:1 1:1 
102:1 102:1 102:1 102:1 102:1 102:1 102:1 102:1 102:1 102:1 102:1 102:1 102:1 102:1 102:1 102:1 102:1 102:1 102:1 102:1 102:1 102:1 102:1 102:1 102:1 102:1 102:1 102:1 102:1 102:1 102:1 102:1 102:1 102:1 102:1 102:1 102:1 102:1 102:1 1:1 
102:1 102:1 102:1 102:1 102:1 102:1 102:1 102:1 102:1 102:1 102:1 102:1 102:1 102:1 102:1 102:1 102:1 102:1 102:1 102:1 102:1 102:1 102:1 102:1 102:1 102:1 102:1 102:1 102:1 102:1 102:1 102:1 102:1 102:1 102:1 102:1 102:1 102:1 102:1 1:1 
102:1 102:1 102:1 102:1 102:1 102:1 102:1 102:1 102:1 102:1 102:1 102:1 102:1 102:1 102:1 102:1 102:1 102:1 102:1 102:1 102:1 102:1 102:1 102:1 102:1 102:1 102:1 102:1 102:1 102:1 102:1 102:1 102:1 102:1 102:1 102:1 102:1 102:1 102:1 1:1 
102:1 102:1 102:1 102:1 102:1 102:1 102:1 102:1 102:1 102:1 102:1 102:1 102:1 102:1 102:1 102:1 102:1 102:1 102:1 102:1 102:1 102:1 102:1 102:1 102:1 102:1 102:1 102:1 102:1 102:1 102:1 102:1 102:1 102:1 102:1 102:1 102:1 102:1 102:1 1:1 
102:1 102:1 102:1 102:1 102:1 102:1 102:1 102:1 102:1 102:1 102:1 102:1 102:1 102:1 102:1 102:1 102:1 102:1 102:1 102:1 102:1 102:1 102:1 102:1 102:1 102:1 102:1 102:1 102:1 102:1 102:1 102:1 102:1 102:1 102:1 102:1 102:1 102:1 102:1 1:1 
102:1 102:1 102:1 102:1 102:1 102:1 102:1 102:1 102:1 102:1 102:1 102:1 102:1 102:1 102:1 102:1 102:1 102:1 102:1 102:1 102:1 102:1 102:1 102:1 102:1 102:1 102:1 102:1 102:1 102:1 102:1 102:1 102:1 102:1 102:1 102:1 102:1 102:1 102:1 1:1 
102:1 102:1 102:1 102:1 102:1 102:1 102:1 102:1 102:1 102:1 102:1 102:1 102:1 102:1 102:1 102:1 102:1 102:1 102:1 102:1 102:1 102:1 102:1 102:1 102:1 102:1 102:1 102:1 102:1 102:1 102:1 102:1 102:1 102:1 102:1 102:1 102:1 102:1 102:1 1:1 
102:1 102:1 102:1 102:1 102:1 102:1 102:1 102:1 102:1 102:1 102:1 102:1 102:1 102:1 102:1 102:1 102:1 102:1 102:1 102:1 102:1 102:1 102:1 102:1 102:1 102:1 102:1 102:1 102:1 102:1 102:1 102:1 102:1 102:1 102:1 102:1 102:1 102:1 102:1 1:1 
102:1 102:1 102:1 102:1 102:1 102:1 102:1 102:1 102:1 102:1 102:1 102:1 102:1 102:1 102:1 102:1 102:1 102:1 102:1 102:1 102:1 102:1 102:1 102:1 102:1 102:1 102:1 102:1 102:1 102:1 102:1 102:1 102:1 102:1 102:1 102:1 102:1 102:1 102:1 1:1 
102:1 102:1 102:1 102:1 102:1 102:1 102:1 102:1 102:1 102:1 102:1 102:1 102:1 102:1 102:1 102:1 102:1 102:1 102:1 102:1 102:1 102:1 102:1 102:1 102:1 102:1 102:1 102:1 102:1 102:1 102:1 102:1 102:1 102:1 102:1 102:1 102:1 102:1 102:1 1:1 
102:1 102:1 102:1 102:1 102:1 102:1 102:1 102:1 102:1 102:1 102:1 102:1 102:1 102:1 102:1 102:1 102:1 102:1 102:1 102:1 102:1 102:1 102:1 102:1 102:1 102:1 102:1 102:1 102:1 102:1 102:1 102:1 102:1 102:1 102:1 102:1 102:1 102:1 102:1 1:1 
102:1 102:1 102:1 102:1 102:1 102:1 102:1 102:1 102:1 102:1 102:1 102:1 102:1 102:1 102:1 102:1 102:1 102:1 102:1 102:1 102:1 102:1 102:1 102:1 102:1 102:1 102:1 102:1 102:1 102:1 102:1 102:1 102:1 102:1 102:1 102:1 102:1 102:1 102:1 1:1 
102:1 102:1 102:1 102:1 102:1 102:1 102:1 102:1 102:1 102:1 102:1 102:1 102:1 102:1 102:1 102:1 102:1 102:1 102:1 102:1 102:1 102:1 102:1 102:1 102:1 102:1 102:1 102:1 102:1 102:1 102:1 102:1 102:1 102:1 102:1 102:1 102:1 102:1 102:1 1:1 
102:1 102:1 102:1 102:1 102:1 102:1 102:1 102:1 102:1 102:1 102:1 102:1 102:1 102:1 102:1 102:1 102:1 102:1 102:1 102:1 102:1 102:1 102:1 102:1 102:1 102:1 102:1 102:1 102:1 102:1 102:1 102:1 102:1 102:1 102:1 102:1 102:1 102:1 102:1 1:1 
102:1 102:1 102:1 102:1 102:1 102:1 102:1 102:1 102:1 102:1 102:1 102:1 102:1 102:1 102:1 102:1 102:1 102:1 102:1 102:1 102:1 102:1 102:1 102:1 102:1 102:1 102:1 102:1 102:1 102:1 102:1 102:1 102:1 102:1 102:1 102:1 102:1 102:1 102:1 1:1 
102:1 102:1 102:1 102:1 102:1 102:1 102:1 102:1 102:1 102:1 102:1 102:1 102:1 102:1 102:1 102:1 102:1 102:1 102:1 102:1 102:1 102:1 102:1 102:1 102:1 102:1 102:1 102:1 102:1 102:1 102:1 102:1 102:1 102:1 102:1 102:1 102:1 102:1 102:1 1:1 
102:1 102:1 102:1 102:1 102:1 102:1 102:1 102:1 102:1 102:1 102:1 102:1 102:1 102:1 102:1 102:1 102:1 102:1 102:1 102:1 102:1 102:1 102:1 102:1 102:1 102:1 102:1 102:1 102:1 102:1 102:1 102:1 102:1 102:1 102:1 102:1 102:1 102:1 102:1 1:1 
102:1 102:1 102:1 102:1 102:1 102:1 102:1 102:1 102:1 102:1 102:1 102:1 102:1 102:1 102:1 102:1 102:1 102:1 102:1 102:1 102:1 102:1 102:1 102:1 102:1 102:1 102:1 102:1 102:1 102:1 102:1 102:1 102:1 102:1 102:1 102:1 102:1 102:1 102:1 1:1 
102:1 102:1 102:1 102:1 102:1 102:1 102:1 102:1 102:1 102:1 102:1 102:1 102:1 102:1 102:1 102:1 102:1 102:1 102:1 102:1 102:1 102:1 102:1 102:1 102:1 102:1 102:1 102:1 102:1 102:1 102:1 102:1 102:1 102:1 102:1 102:1 102:1 102:1 102:1 1:1 
102:1 102:1 102:1 102:1 102:1 102:1 102:1 102:1 102:1 102:1 102:1 102:1 102:1 102:1 102:1 102:1 102:1 102:1 102:1 102:1 102:1 102:1 102:1 102:1 102:1 102:1 102:1 102:1 102:1 102:1 102:1 102:1 102:1 102:1 102:1 102:1 102:1 102:1 102:1 1:1 
102:1 102:1 102:1 102:1 102:1 102:1 102:1 102:1 102:1 102:1 102:1 102:1 102:1 102:1 102:1 102:1 102:1 102:1 102:1 102:1 102:1 102:1 102:1 102:1 102:1 102:1 102:1 102:1 102:1 102:1 102:1 102:1 102:1 102:1 102:1 102:1 102:1 102:1 102:1 1:1 
102:1 102:1 102:1 102:1 102:1 102:1 102:1 102:1 102:1 102:1 102:1 102:1 102:1 102:1 102:1 102:1 102:1 102:1 102:1 102:1 102:1 102:1 102:1 102:1 102:1 102:1 102:1 102:1 102:1 102:1 102:1 102:1 102:1 102:1 102:1 102:1 102:1 102:1 102:1 1:1 
102:1 102:1 102:1 102:1 102:1 102:1 102:1 102:1 102:1 102:1 102:1 102:1 102:1 102:1 102:1 102:1 102:1 102:1 102:1 102:1 102:1 102:1 102:1 102:1 102:1 102:1 102:1 102:1 102:1 102:1 102:1 102:1 102:1 102:1 102:1 102:1 102:1 102:1 102:1 1:1 
1:1 1:1 1:1 1:1 1:1 1:1 1:1 1:1 1:1 1:1 1:1 1:1 1:1 1:1 1:1 1:1 1:1 1:1 1:1 1:1 1:1 1:1 1:1 1:1 1:1 1:1 1:1 1:1 1:1 1:1 1:1 1:1 1:1 1:1 1:1 1:1 1:1 1:1 1:1 1:1 
